111111111111111111111
10000000C0000000000C1
10000C000000C00000001
10C00000000000000C001
1C000P00E000000000001
100C0000C0000000C0C01
10C0000C0C00000C000C1
100000000000000000001
10C00C00C00000000C001
10000000C000000000001
111111111111111111111